################################
#..............≈≈..............#
#..♣.............≈≈.............#
#..♣.............%...%..........#
#.................%%............#
#...▥▥▥............%............#
#...▥▥▥.....@...........▣▣▣.....#
#...▥▥▥.................▣▣▣.....#
#...▥▥▥......................▣▣▣#
#...............$...............#
#.............%.....⌂...........#
############░░##################